NO ./textures/lava.png
SO ./textures/metal.png
WE ./textures/rock.png
EA                   ./          textures/water.png

F 220,100,0
C 225,30,0

1            111111111
10000000        01
10010           10001
1001010001
1000000001
1000000001
1111111111
