NO ./textures/pics/mossy.png
EA ./textures/pics/redbrick.png
WE ./textures/pics/greystone.png
SO ./textures/pics/mossy.png

F 0,255,0
C 255,0,255

1111111111
1100000001
1001N10001
100101000111
100000000D01
100000000111
1111111111
