NO ./textures/pics/mossy.png
EA ./textures/pics/redbrick.png
WE ./textures/pics/greystone.png
SO ./textures/pics/mossy.png

F 127,127,127
C 0,100,200

1111111111
1100000001
1001010001
10010100011
10000W000D1
10000000011
11111111111
