NO ./textures/pics/mossy.png
EA ./textures/pics/redbrick.png
WE ./textures/pics/greystone.png
SO ./textures/pics/mossy.png

F 0,255,0
C 255,0,255

1111111111
1100000001
1001S10001
10010100011
100000000D1
10000000011
11111111111
