NO ./textures/pics/mossy.png
EA ./textures/pics/redbrick.png
WE ./textures/pics/greystone.png
SO ./textures/pics/mossy.png

F 127,127,127
C 127,127,127

 11
 1 1
 1 111111
 1E   0001
 11111111
