NO ./textures/pics/mossy.png
EA ./textures/pics/redbrick.png
WE ./textures/pics/greystone.png
SO ./textures/pics/mossy.png

F 127,127,127
C 127,127,127

1111
1 11
111111111
1E1110001
111111111
