         NO ./textures/pics/mossy.png   
	EA	./textures/pics/redbrick.png
WE         ./textures/pics/greystone.png               
SO ./textures/pics/mossy.png		

F	127 ,     127     ,             127              
               C           127,127   , 127   

        101111111111111111111111D
        100D000000110000000000001
        1011000001110000000000001
        10010000000D0000000000001
111111111011000001110000000000001
10000000001100000111011111D111111
1111D111111111D11100000010001
11110111101111011101010010001
11000000110101011100000010001
10000000000000001100000010001
10000000000000001101010010001
110000011101D1D111110111100011
11110111 1110101 101111010001
11111111 11111N1 111111111111
11111111 1111111 111111111111
